1111111
1000001
1CPCCE1
1111111
