1111111
1000001
10BPB01
1C000E1
1111111
