111111111111111111111
100000000010000100011
100000000010000000001
100P00000000100000001
100000000010000000001
10000C000010000C00001
100100000010001000001
1000000E0000000000101
100000000010000100001
100010000010000000001
111011101111101110111
10000000001C0001000C1
100001000010000000001
1001001000000C000C001
100000000111000100001
10000C000011000C00001
110000000010000010001
1000000000001C000C001
101001000010000000001
10001000001C1000001C1
111111111111111111111