1111111
100CE01
1P10001
1C00C11
1111111
1111111
1111111





