1111111111111
1001000000101
1000011010101
1P001100000E1
1111111111111
