1111111111
10000C00E1
100C110001
1P000B00B1
1111111111
