1111111111111111111
1E0000000000B00C001
1010010100100000101
1010010010101010001
1P000000BC00C000001
1111111111111111111
