1111111111111
10010000001C1
1000011010101
1P00110000C01
1111111111111
