1111111111111
10010000001C1
1000011010101
100011E000C01
1111111111111
