1111111111
1P00100001
1010101101
10101011E1
1C1CCCCCC1
1111111111