1111111111111
10010100001C1
1000011010101
1P00110000CE1
1111111111111
